###########################################
#                                       ! #
#  !                                      #
#               ##                        #
#              ###     !            !     #
#         !    ###            !           #
#              ##                         #
#                                         #
#    !              !      ##         !   #
#                          ##             #
#                  AAAA    ##             #
#      !           AAAA                   #
#            !     AAAA         !    !    #
#                  AAAA                   #
#  !                                      #
#                                         #
#                   ##    !               #
#               !   ##                    #
#    !              ##       !       !    #
#           !       ##                ##  #
#                                     ##  #
#                                     ### #
###########################################
